{
    "width":20,
    "height":11,
    "board":[
        [0, 0, 2, 2, 2, 2, 2, 2, 2, 2, 2, 2, 2, 2, 2, 2, 2, 2, 2, 2],
        [0, 0, 2, 2, 0, 0, 0, 0, 0, 0, 0, 0, 0, 2, 2, 0, 4, 4, 2, 2],
        [1, 0, 0, 0, 0, 0, 2, 2, 0, 0, 0, 5, 0, 2, 2, 0, 0, 0, 2, 2],
        [0, 0, 2, 2, 0, 0, 0, 2, 2, 2, 2, 0, 2, 2, 2, 2, 0, 0, 0, 2],
        [0, 0, 2, 2, 0, 0, 3, 2, 2, 2, 2, 2, 2, 2, 2, 2, 2, 0, 2, 2],
        [0, 2, 2, 3, 3, 3, 3, 0, 0, 0, 2, 2, 2, 2, 2, 2, 2, 0, 2, 2],
        [2, 2, 2, 3, 3, 0, 2, 2, 2, 0, 0, 2, 0, 0, 0, 2, 0, 2, 2, 2],
        [2, 2, 2, 3, 3, 2, 2, 2, 2, 2, 0, 0, 0, 0, 0, 3, 3, 0, 3, 2],
        [2, 2, 2, 2, 2, 2, 2, 2, 2, 2, 0, 0, 0, 0, 3, 0, 0, 4, 0, 2],
        [2, 2, 2, 2, 2, 2, 2, 2, 2, 2, 0, 0, 0, 0, 0, 0, 3, 4, 0, 0],
        [2, 2, 2, 2, 2, 2, 2, 2, 2, 2, 2, 0, 0, 0, 0, 0, 3, 0, 3, 0]
    
    ],
    "values":{
        "1":"player",
        "2":{
            "symbol":"W",
            "behavior":"wall",
            "hitDice":"12",
            "name":"wall"
        },
        "3":{"monster":"rat"},
        "4":{"monster":"dire rat"},
        "5":{"monster":"ogre"},
        "6":{"monster":"goblin"}
    }
}